36 27
AAAAAAAAAAAAAAAAAAAAAAAAAAAAAAAAAAAA
ABBBBBBBBBBBBBBBBBBBBBBBBBBBBBBBBBAA
ABBBBBBBBBBBBBBBBBBFFBBBBBBBBWWBBBAA
ABBBBBBBBBBBAAABBBBFFBBBBBBBBWWBBBAA
ABBBBBBBBBBBBBAAAAAAAAAAAAAAAAAAAAAA
AAAAAABBBBBBBBBBBBBBBBBBAAAABBBBBBAA
AAAAAABBBBBBBBBBBBBBBBBBBBBBBBBBBBAA
AAAAAABAAABBBBBBAAAAABBBBBBBBBBBBBAA
AAAAAABBBBBBBBBBAAAAAAABBBBBBBBBBBAA
AAAAAAAAAAAAAAAAAAAAAAAAAAABBBBBBBAA
ABBBBBBBBBBBBBBBBBBBBBBAAAABBBBBBBAA
ABBBBBBBBBBBBBBBBBBBBBBBBBBBBBBBBBAA
ABBBBBBBBBBBBBBBBBBBBBBBBBBBBBBAAAAA
ABBBBBBAAAAAAAAABBBBBBBBBBBBBBBBBBAA
ABBBBBBBBBBBBAAAAAAAAAAAAAAAAAAAAAAA
ABBBBBBBBBBBBBBBBBBRBBBBBBBAAAAAAAAA
ABAAAAABBBBBBBBBBBBRBBBBBBBBBBAAAAAA
ABBBBBBBBBBBBBBBBBBXBBBBBBBBBBBRAAAA
AAAAAAAAAAAABBBBBBBBBBBBBBBBBBBRBBAA
ABBBBBBBBBBAAAAAAVVVVVAAAAABBBBXBBAA
ABBBBBBBBBBBBBBBBBBBBBBBBBBBBBBBBBAA
ABBBBBBBBBBBBBBBBBBBBBBBBBBBBBBBBBAA
AAAAAAAAAABBBBBBBBBBBBBBBBBBBBBBBBAA
ABBBBBBBBBBBBBBBBBBBBBBBBBBBBBBAAAAA
ABBBBBBBBBBBBBBBBBBBBBBBBBBBBBBAAAAA
ABBBBBBBBBBBBBBBBBBBBBBBBBBBBBBAAAAA
AAAAAAAAAAAAAALLLLLAAAAPPPPPAAAAAAAA
