36 27
AAAAAAAAAAAAAAAAAAAAAAAAAAAAAAAAAAA
ABBBBBBBBBBBBBBBBBBBBBBBBBBBBBBBBBA
ABBBBBBBBBBBBBBBBBBFFBBBBBBBBWWBBBA
ABBBBBBBBBBBAAABBBBFFBBBBBBBBWWBBBA
ABBBBBBBBBBBBBAAAAAAAAAAAAAAAAAAAAA
AAAAAABBBBBBBBBBBBBBBBBBAAAABBBBBBA
AAAAAABBBBBBBBBBBBBBBBBBBBBBBBBBBBA
AAAAAABAAABBBBBBAAAAABBBBBBBBBBBBBA
AAAAAABBBBBBBBBBAAAAAAABBBBBBBBBBBA
AAAAAAAAAAAAAAAAAAAAAAAAAAABBBBBBBA
ABBBBBBBBBBBBBBBBBBBBBBAAAABBBBBBBA
ABBBBBBBBBBBBBBBBBBBBBBBBBBBBBBBBBA
ABBBBBBBBBBBBBBBBBBBBBBBBBBBBBBAAAA
ABBBBBBAAAAAAAAABBBBBBBBBBBBBBBBBBA
ABBBBBBBBBBBBAAAAAAAAAAAAAAAAAAAAAA
ABBBBBBBBBBBBBBBBBBBBBBBBBBAAAAAAAA
ABAAAAABBBBBBBBBBBBBBBBBBBBBBBAAAAA
ABBBBBBBBBBBBBBBBBBBBBBBBBBBBBBBAAA
AAAAAAAAAAAABBBBBBBBBBBBBBBBBBBBBBA
ABBBBBBBBBBAAAAAAAAAAAAAAAABBBBBBBA
ABBBBBBBBBBBBBBBBBBBBBBBBBBBBBBBBBA
ABBBBBBBBBBBBBBBBBBBBBBBBBBBBBBBBBA
AAAAAAAAAABBBBBBBBBBBBBBBBBBBBBBBBA
ABBBBBBBBBBBBBBBBBBBBBBBBBBBBBBAAAA
ABBBBBBBBBBBBBBBBBBBBBBBBBBBBBBAAAA
ABBBBBBBBBBBBBBBBBBBBBBBBBBBBBBAAAA
AAAAAAAAAAAAAALLLLLAAAAPPPPPAAAAAAA
