36 27
AAAAAAAAAAAAAAAAAAAAAAAAAAAAAAAAAAA
ABBBBBBBBBBBBBBBBBBBBBBBBBBBBBBBBBA
ABBBBBBBBBBBBBBBBBBBBBBBBBBBBBBBBBA
ABBBBBBBBBBBBBBBBBBBBBBBBBBBBBBBBBA
AAAAAAAABBBBBBBBBBBBBBBBBBBAAAAAAAA
ABBBRBAAAABBBBBBBBBBBBBBAAAABBBBBBA
ABBBRBBBBBBAAAAAAAAAABBBBBBBBBBBBBA
ABBBRBBBBBABBBBBBBBBAABBBBBBBBBBBBA
ABBBBBBBBBBBBBBBBBBBBBBBBBBBBBBBBBA
AAAAAAAABBBBBBBBBBBBBBBBBAAAAAAAABA
ABBBBBBBBBBBBBBBBBBBBBBAAAABBBBBBBA
ABBBBBBBBBBBBBBBBBBBBBBBBBBBBBBBBBA
ABBBBBBBAAAAAAAAAAAAAAAABBBBBBBBBBA
ABBBBBBAAAABBBBBBBBBBBBBBBBBBBBBBBA
AAAABBBBBBBBBBBBBBBBBBBBBBBBBBBBBBA
AAAABBBBBBBBBBBBBBBBBBBBBBBBBBBBBBA
ABAAAABBBBBBBBBBBBBBBBBBBBBBBBBBBBA
ABBBBBBBBBAABBBBBBBBBBBBBBBBBBBBBBA
ABBBBBBBBBAABBBBBBAABBBBBBBBBBBBBBA
ABBBAAABBBBBBBBBBBBBBBBBBBBBBBBBBBA
ABBBAAABBBBBBBBBBBBBBBBBBBBBBBBBBBA
AAAAAAAAAAAAABBBBBBBBBAAAPPPPPAAAAA
ABBBBBBBBBBBBBBBBBBBBBBBBBBBBBBBBBA
ABBBBBBBBBBBBBBBAABBBBBBBBBBBBBBBBA
ABBBBBBBBBBBBBBBAABBBBBBBBBBBBBBBBA
ABBBBBBBBBBBBBBBAABBBBBBBBBBBBBBBBA
AAALLLLLAAAAAAAAAAAAAAAAAAAAAAAAAAA
