36 27
AAAAAAAAAAAAAAAAAAAAAAAAAAAAAAAAAAA
ABBBBBBBBBBBBBBBBBBBBBBBBBBBBBBBBBA
ABBBBBBBBBBBBBBBBBBBBBBBBBBBBBBBBBA
ABBBBBBBBBBBBBBBBBBBBBBBBBBBBBBBBBA
AAAAAAAABBBBBBBBBBBBBBBBBBBAAAAAAAA
ABBBBBAAAABBBBBBBBBBBBBBAAAABBBBBBA
ABBBBBBBBBBAAAAAAAAAABBBBBBBBBBBBBA
ABBBBBBBBBABBBBBBBBBAABBBBBBBBBBBBA
ABBBBBBBBBBBBBBBBBBBBBBBBBBBBBBBBBA
AAAAAAAABBBBBBBBBBBBBBBBBAAAAAAAABA
ABBBBBBBBBBBBBBBBBBBBBBAAAABBBBBBBA
ABBBBBBBBBBBBBBBBBBBBBBBBBBBBBBBBBA
ABBBBBBBAAAAAAAAAAAAAAAABBBBBBBBBBA
ABBBBBBAAAABBBRBBBBBBBBBBBBBBBBBBBA
AAAABBBBBBBBBBRBBBBBBBBBBBBBBBBBBBA
AAAABBBBBBBBBBRBBBBBBBBBBBBBBBBBBBA
ABAAAABBBBBBBBXBBBBBBBBBBBBBBBBBBBA
ABBBBBBBBBAABBBBBBBBBBBBBBBBBBBBBBA
ABBBBBBBBBAABBBBBBAABBBBBBBBBBBBBBA
ABBBAAABBBBBBBBBBBBBBBBBBBBBBBBBBBA
ABBBAAABBBBBBBBBBBBBBBBBBBBBBBBBBBA
AAAAAAAAAAAAABBBBBBBBBAAAPPPPPAAAAA
ABBBBBBBBBBBBBBBBBBBBBBBBBBBBBBBBBA
ABBBBBBBBBBBBBBBAABBBBBBBBBBBBBBBBA
ABBBBBBBBBBBBBBBAABBBBBBBBBBBBBBBBA
ABBBBBBBBBBBBBBBAABBBBBBBBBBBBBBBBA
AAALLLLLAAAAAAAAAAAAAAAAAAAAAAAAAAA
