36 27
AAAAAAAAAAAAAAAAAAAAAAAAAAAAAAAAAAAA
ABBBBBBBBBBBBBBBBBBBBBBBBBBBBBBBBBBA
ABBBBBBBBBBBBBBBBBBBBBBBBBBBBBBBBBBA
ABBBBBBBBBBBBBBBBBBBBBBBBBBBBBBBBBBA
ABBBBBBBBBBBBBBBBBBBBBBBBBBBBBBBBBBA
ABBBBBBBBBBBBBBBBBBBBBBBBBBBBBBBBBBA
ABBBBBBBBBBBBBBBBBBBBBBBBBBBBBBBBBBA
ABBBBBBBBBBBBBBBBBBBBBBBBBBBBBBBBBBA
ABBBBBBBBBBBBBBBBBBBBBBBBBBBBBBBBBBA
ABBBBBBBBBBBBBBBBBBBBBBBBBBBBBBBBBBA
ABBBBBBBBBBBBBBBBBBBBBBBBBBBBBBBBBBA
ABBBBBBBBBBBBBBBBBBBBBBBBBBBBBBBBBBA
ABBBBBBBBBBBBBBBBBBBBBBBBBBBBBBBBBBA
ABBBBBBBBBBBBBBBBBBBBBBBBBBBBBBBBBBA
ABBBBBBBBBBBBBBBBBBBBBBBBBBBBBBBBBBA
ABBBBBBBBBBBBBBBBBBBBBBBBBBBBBBBBBBA
ABBBBBBBBBBBBBBBBBBBBBBBBBBBBBBBBBBA
ABBBBBBBBBBBBBBBBBBBBBBBBBBBBBBBBBBA
ABBBBBBBBBBBBBBBBBBBBBBBBBBBBBBBBBBA
ABBBBBBBBBBBBBBBBBBBBBBBBBBBBBBBBBBA
ABBBBBBBBBBBBBBBBBBBBBBBBBBBBBBBBBBA
ABBBBBBBBBBBBBBBBBBBBBBBBBBBBBBBBBBA
AAAAAAAAABBBBBBBBBBBBBBBBBBBBBBBBBBA
ABBBBBBBBBBBBBBBBBBBBBBBBBBBBBBBBBBA
ABBBBBBBBBBBBBBBBBBBBBBBBBBBBBBBBBBA
ABBBBBBBBBBBBBBBBBBBBBBBBBBBBBBBBBBA
AAAAAAAAAAAAAAAAAAAAAAAAAAAAAAAAAAAA
