36 27
AAAAAAAAAAAAAAAAAAAAAAAAAAAAAAAAAAA
ABBBBBBBBBBBBBBBBBBBBBBBBBBBBBBBBBA
ABBWWBBBBBBBBBBBBBBBBBBBBBBBBFFBBBA
ABBWWBBBBBBBBBBBBBBBBBBBBBBBBFFBBBA
AAAAAAAABBBBBBBBBBBBBBBBBBBAAAAAAAA
ABBBBBAAAABBBBBBBBBBBBBBAAAABBBBBBA
ABBBBBBBBBBAAAAAAAAAABBBBBBBBBBBBBA
ABBBBBBBBBABBBBBBBBBAABBBBBBBBBBBBA
ABBBBBBBBBBBBBBBBBBBBBBBBBBBBBBBBBA
AAAAAAAABBBBBBBBBBBBBBBBBAAAAAAAABA
ABBBBBBBBBBBBBBBBBBBBBBAAAABBBBBBBA
ABBBBBBBBBBBBBBBBBBBBBBBBBBBBBBBBBA
ABBBBBBBAAAAAAAAAAAAAAAABBBBBBBBBBA
ABBBBBBAAAABBBBBBBBBBBBBBBBBBBBBBBA
AAAABBBBBBBBBBBBBBBBBBBBBBBBBBBBBBA
AAAABBBBBBBBBBBBBBBBBBBBBBBBBBBBBBA
ABAAAABBBBBBBBBBBBBBBBBBBBBBBBBBBBA
ABBBBBBBBBAABBBBBBBBBBBBBBBBBBBBBBA
ABBBBBBBBBAABBBBBBAABBBBBBBBBBBBBBA
ABBBAAABBBBBBBBBBBBBBBBBBBBBBBBBBBA
ABBBAAABBBBBBBBBBBBBBBBBBBBBBBBBBBA
AAAAAAAAAAAAABBBBBBBBBAAAPPPPPAAAAA
ABBBBBBBBBBBBBBBBBBBBBBBBBBBBBBBBBA
ABBBBBBBBBBBBBBBAABBBBBBBBBBBBBBBBA
ABBBBBBBBBBBBBBBAABBBBBBBBBBBBBBBBA
ABBBBBBBBBCBBBBBAABBBBBBBBBBBBBBBBA
AAALLLLLAAAAAAAAAAAAAAAAAAAAAAAAAAA
