36 27
AAAAAAAAAAAAAAAAAAAAAAAAAAAAAAAAAAAA
ABBBBBBBBBBBBBBBBBBBBBBBBBBBBBBBBBBA
ABBBBBBBBBBBBBBBBBBBBBBBBBBBBBBBBBBA
ABBBBBBBBBBBBBBBBBBBBBBBBBBBBBBBBBBA
AAAAAAAABBBBBBBBBBBBBBBBBBBBAAAAAAAA
ABBBBBAAAABBBBBBBBBBBBBBBAAAABBBBBBA
ABBBBBBBBBBAAAAAAAAAAABBBBBBBBBBBBBA
ABBBBBBBBBAABBBBBBBBBAABBBBBBBBBBBBA
ABBBBBBBBBBBBBBBBBBBBBBBBBBBBBBBBBBA
AAAAAAAABBBBBBBBBBBBBBBBBBAAAAAAAABA
ABBBBBBBBBBBBBBBBBBBBBBBAAAABBBBBBBA
ABBBBBBBBBBBBBBBBBBBBBBBBBBBBBBBBBBA
ABBBBBBBBAAAAAAAAAAAAAAAABBBBBBBBBBA
ABBBBBBBAAAABBBBBBBBBBBBBBBBBBBBBBBA
AAAAABBBBBBBBBBBBBBBBBBBBBBBBBBBBBBA
AAAAABBBBBBBBBBBBBBBBBBBBBBBBBBBBBBA
ABAAAABBBBBBBBBBBBBBBBBBBBBBBBBBBBBA
ABBBBBBBBBAABBBBBBBBBBBBBBBBBBBBBBBA
ABBBBBBBBBAABBBBBBBAABBBBBBBBBBBBBBA
ABBBAAABBBBBBBBBBBBBBBBBBBBBBBBBBBBA
ABBBAAABBBBBBBBBBBBBBBBBBBBBBBBBBBBA
AAAAAAAAAAAAABBBBBBBBBBAAAAAAAAAAAAA
ABBBBBBBBBBBBBBBBBBBBBBBBBBBBBBBBBBA
ABBBBBBBBBBBBBBBBAABBBBBBBBBBBBBBBBA
ABBBBBBBBBBBBBBBBAABBBBBBBBBBBBBBBBA
ABBBBBBBBBBBBBBBBAABBBBBBBBBBBBBBBBA
AAAAAAAAAAAAAAAAAAAAAAAAAAAAAAAAAAAA
