36 27
AAAAAAAAAAAAAAAAAAAAAAAAAAAAAAAAAAAA
ABBBBBBBBBBBBBBBBBBBBBBBBBBBBBBBBBAA
ABBBBBBBBBBBBBBBBBBBBBBBBBBBBBBBBBAA
ABBBBBBBBBBBBBBBBBBBBBBBBBBBBBBBBBAA
ABBBAAAAAAAAAAABBBBBAAAAAAAAAAABBBAA
ABBBBBBBABBBBBBBBBBBBBBBBBABBBBBBBAA
ABBBBBBBABBBBBBBBBBBBBBBBBABBBBBBBAA
AAAABBBBABBBBBBBBABBBBBBBBABBBBAAAAA
ABBBBBBBABBBBBBBAAABBBBBBBABBBBBBBAA
ABBBBBAAABBBBBBBBABBBBBBBBAAABBBBBAA
ABBBBBBBABBBBBBBBABBBBBBBBABBBBBBBAA
ABBBBBBBALLLLLBBBABBBPPPPPABBBBBBBAA
AAAAABBBABBBBBBBBABBBBBBBBABBBAAAAAA
ABBBBBBBABBBBBBBBABBBBBBBBABBBBBBBAA
ABBBBBBBABBBBWWBAAABFFBBBBABBBBBBBAA
ABBBBBBAABBBBWWAAAAAFFBBBBAABBBBBBAA
ABBBBAAAAAAAAAAAAAAAAAAAAAAAAABBBBAA
ABBBBBBBBBBBBBBBBBBBBBBBBBBBBBBBBBAA
AABBBBBBBBBBBBBBBBBBBBBBBBBBBBBBBAAA
AAABBBBBBBBBBBBBBBBBBBBBBBBBBBBBAAAA
AAAAAAAPPPPPAAABBBBBAAALLLLLAAAAAAAA
ABBBBBBBBBBBBBBBBBBBBBBBBBBBBBBBBBAA
ABBBBBBBBBBBBBBBBBBBBBBBBBBBBBBBBBAA
ABBBBBBBBBBBBBBBAAABBBBBBBBBBBBBBBAA
ABBBBBBBBBBBBBBAAAAABBBBBBBBBBBBBBAA
ABBBBBBBBBBBBBAAAAAAABBBBBBBBBBBBBAA
AAAAAAALLLLLAAAAAAAAAAAPPPPPAAAAAAAA
