36 27
AAAAAAAAAAAAAAAAAAAAAAAAAAAAAAAAAAA
ABBBBBBBBBBBBBBBBBBBBBBBBBBBBBBBBBA
ABBBBBBBBBBBBBBBBBBBBBBBBBBBBBBBBBA
ABBBBBBBBBBBBBBBBBBBBBBBBBBBBBBBBBA
ABBBAAAAAAAAAAABBBBBAAAAAAAAAAABBBA
ABBBBBBBABBBBBBBBBBBBBBBBBABBBBBBBA
ABBBBBBBABBBBBBBBBBBBBBBBBABBBBBBBA
AAAABBBBABBBBBBBBABBBBBBBBABBBBAAAA
ABBBBBBBABBBBBBBAAABBBBBBBABBBBBBBA
ABBBBBAAABBBBBBBBABBBBBBBBAAABBBBBA
ABBBBBBBABBBBBBBBABBBBBBBBABBBBBBBA
ABBBBBBBALLLLLBBBABBBPPPPPABBBBBBBA
AAAAABBBABBBBBBBBABBBBBBBBABBBAAAAA
ABBBBBBBABBBBBBBBABBBBBBBBABBBBBBBA
ABBBBBBBABBBBBBBAAABBBBBBBABBBBBBBA
ABBBBBBAABBBBBBAAAAABBBBBBAABBBBBBA
ABBBBAAAAAAAAAAAAAAAAAAAAAAAAABBBBA
ABBBBBBBBBBBBBBBBBBBBBBBBBBBBBBBBBA
AABBBBBBBBBBBBBBBBBBBBBBBBBBBBBBBAA
AAABBBBBBBBBBBBBBBBBBBBBBBBBBBBBAAA
AAAAAAAPPPPPAAABBBBBAAALLLLLAAAAAAA
ABBBBBBBBBBBBBBBBBBBBBBBBBBBBBBBBBA
ABBBBBBBBBBBBBBBBBBBBBBBBBBBBBBBBBA
ABBBBBBBBBBBBBBBAAABBBBBBBBBBBBBBBA
ABBBBBBBBBBBBBBAAAAABBBBBBBBBBBBBBA
ABBBBBBBBBBBBBAAAAAAABBBBBBBBBBBBBA
AAAAAAALLLLLAAAAAAAAAAAPPPPPAAAAAAA
