36 27
AAAAAAAAAAAAAAAAAAAAAAAAAAAAAAAAAAA
ABBBBBBBBBBBBBBBBBBBBBBBBBBBBBBBBBA
ABBBBBBBBBBBBBBBBBBBBBBBBBBBBBBBBBA
ABBBBBBBBBBBBBBBBBBBBBBBBBBBBBBBBBA
ABBBAAAAAAAAAAAAABBAAAAAAAAAAAABBBA
ABBBBBBBABBBBBBBBBBBBBBBBBABBBBBBBA
ABBBBBBBABBBBBBBBBBBBBBBBBABBBBBBBA
AAAABBBBABBBBBBBBAABBBBBBBABBBBAAAA
ABBBBBBBABBBBBBBAAAABBBBBBABBBBBBBA
ABBBBBAAABBBBBBAAAAAABBBBBAAABBBBBA
ABBBBBBBABBBBBBBAAAABBBBBBABBBBBBBA
ABBBBBBBALLLLBBBAAAABBPPPPABBBBBBBA
AAAAAABBABBBBBBBBAABBBBBBBABBAAAAAA
ABBBBBBBABBBBBBBBAABBBBBBBABBBBBBBA
ABBBBBBBABBBBBBBAAAABBBBBBABBBBBBBA
ABBBBBBAABBBBBBAAAAAABBBBBABBBBBBBA
ABBBBAAAAAAAAAAAAAAAAAAAAAAAAABBBBA
ABBBBBBBBBBBBBBBBBBBBBBBBBBBBBBBBBA
AABBBBBBBBBBBBBBBBBBBBBBBBBBBBBBBAA
AABBBBBBBBBBBBBBBBBBBBBBBBBBBBBBBAA
AAAAAPPPPPPPAAABBBBBBAALLLLLLLAAAAA
ABBBBBBBBBBBBBBBBBBBBBBBBBBBBBBBBBA
ABBBBBBBBBBBBBBBBBBBBBBBBBBBBBBBBBA
ABBBBBBBBBBBBBBAAAAAABBBBBBBBBBBBBA
ABBBBBBBBBBBBBAAAAAAAABBBBBBBBBBBBA
ABBBBBBBBBBBBBAAAAAAAABBBBBBBBBBBBA
AAAAALLLLLLLAAAAAAAAAAAPPPPPPPAAAAA
