36 27
AAAAAAAAAAAAAAAAAAAAAAAAAAAAAAAAAAAA
ABBBBBBBBBBBBBBBBBBBBBBBBBBBBBBBBBBA
ABBBBBBBBBBBBBBBBBBBBBBBBBBBBBBBBBBA
ABWWBBBBBBBBBBBBBBBBBBBBBBBBBBBBBBBA
ABWWBBBBBBBBBBBBBBBBBBBBBBBBBBBBBBBA
AAAAAAAAAAAAAAAAAAAAAAAAAAABBBBBBBBA
ABBBBBBBBBBRBBBBRBBBBRBBBBBBBBBBBBBA
ABBBBBBBBBBRBBBBRBBBBRBBBBBBBBBBAAAA
ABBBBBBBBBBRBBBBRBBBBRBBBBBBBBBBBBBA
ABBBBBBBBBBRBBBBRBBBBRBBBBBBBBBBBBBA
ABBBBBBBBBBXBBBBXBBBBXBBAPPPPPABBBBA
ABBBBBBBBBBBBBBBBBBBBBBBBBBBBBBBBBBA
ABBBBBBBBBBBBBBBBBBBBBBBBBBBBBBBBBBA
ABBBBBBBBBBBBBBBBBBBBBBBBBBBBBBBBBBA
ABBBBBBBBBBBBBBBBBBBBBBBBBBBBBBAABBA
ABFFBBBBBBBBBBBBBBBBBBBBBBBBBBBBBBBA
ABFFBBBBBBBBBBBBBBBBBBBBBBBBBBBBBBBA
AAAAAAAAAPPPPPPPPPPPPPPPABBBBBBBBBBA
ABBBBBBBBBBBBBBBBBBBBBBBBBBAABBBBBAA
ABBBBBBBBBBBBBBBBBBBBBBBBBBBBBBBBBBA
ABBBBBBBBBBBBBBBBBBBBBBBBBBBBBBBBBBA
ABBBBBBBBBBBBBBBBBBBBBBBBBBBBBBBAAAA
ABBBBBBBBBBBBBBBBBBBAABBBBBBBBBBAAAA
ABBBBBBBBBBBBBBBBBBBBBBBBBBBBBBBAAAA
ABBBBBBBBBBBBBAABBBBBBBBBBAABBBBAAAA
ABBBBBBBBBBBBBBBBBBBBBBBBBBBBBBBAAAA
AAAAAAAAAAAVVVVVVVVVVVVVVVVVVVVAAAAA
